############################################################
#......................|||||...............................#
#.................##########....||||||||||||||.............#
#.....@.........#########......|||||||||||||||.............#
#..........................|||||||||||||.@.................#
#..########|||||.........|||||||||||||||||.................#
#..########|||||...........|||||||||||||||||||.............#
#..########|||||............||||||||||||||||||.....##......#
#..########|||||..............|||||||||||||||....#####.....#
#.............................||||||||||||||...########....#
#...##################.........||||||||||||..###########...#
#.|||||.....#########...........|||||||||......########....#
#...||.#############............||||||||||......######.....#
#.......#############............................####......#
#.................................................##.......#
#..........................................................#
#..........................................................#
#..............##########..................................#
#.............##############...............................#
#............##################............................#
#...........####################...........................#
#...........####################...........................#
#...........####################...........................#
#...........####################...........................#
#...........####################...........||||||..........#
#...........####################...........||||||..........#
#...........####################..........||||||...........#
#...........####################..........||||||...........#
#...........####################..........||||||...........#
#...........###################...........||||||...........#
#............#################............||||||...........#
#....########################.............||||||...........#
#..|||||...@.##############................||||||..........#
#....||.#################..................||||||..........#
#........###############...................................#
#..........................................................#
#..........................................................#
#..........|||||||.........................................#
#..........||||||||........................................#
#..........||||||||||......................................#
#........||||||||||||||....................................#
#......|||||||||||||||||...................................#
#..........||||||...||||||.................................#
#..........||||||...||||...................................#
#.........|||||....|||||||.................................#
#.......|||||||....|||||||.........####....................#
#........|||||||.....||||||.......######...................#
#...........|||||.....||||.......###..###..................#
#................................##..@.##..................#
#.................................##..##...................#
#..........................................................#
#..........................................................#
#..........................................................#
#..........................................................#
#..........................................................#
#..........................................................#
#..........................................................#
#..........................................................#
#..........................................................#
############################################################