%%%%%%%%%%%%%%%%%%%%%%%%%%%%%%
%%%%%%%%%%%%%%%%%%%%%%%%%%%%%%
%%******%%*********%%*******%%
%%!%%%%*%%*%%%%%%%*%%*%%%%%!%%
%%*%%%%*%%*%%%%%%%*%%*%%%%%*%%
%%**************************%%
%%%%*%%*%%%%%*%%*%%%%%*%%*%%%%
%%%%*%%*%%%%%*%%*%%%%%*%%*%%%%
%%%%*%%*%%%%%*%%*%%%%%*%%*%%%%
++++*%%*******%%*******%%*++++
%%%%*%%%%%+%%%%%%%%+%%%%%*%%%%
%%%%*%%%%%+%%%%%%%%+%%%%%*%%%%
%%%%*++++++++++++++++++++*%%%%
%%%%*%%%%%+%%%++%%%+%%%%%*%%%%
%%%%*%%%%%+%++++++%+%%%%%*%%%%
%%%%*%%++++%++++++%++++%%*%%%%
%%%%*%%+%%+%++++++%+%%+%%*%%%%
%%%%*%%+%%+%%%%%%%%+%%+%%*%%%%
++++*+++%%++++++++++%%+++*++++
%%%%*%%%%%%%%+%%+%%%%%%%%*%%%%
%%%%*%%%%%%%%+%%+%%%%%%%%*%%%%
%%%%*******+++%%+++*******%%%%
%%%%*%%%%%*%%%%%%%%*%%%%%*%%%%
%%%%*%%%%%*%%%%%%%%*%%%%%*%%%%
%%************++************%%
%%*%%%%*%%%%%*%%*%%%%%*%%%%*%%
%%*%%%%*%%%%%*%%*%%%%%*%%%%*%%
%%*%%%%*%%****%%****%%*%%%%*%%
%%!%%%%*%%*%%%%%%%%*%%*%%%%!%%
%%*%%%%*%%*%%%%%%%%*%%*%%%%*%%
%%**************************%%
%%%%%%%%%%%%%%%%%%%%%%%%%%%%%%
%%%%%%%%%%%%%%%%%%%%%%%%%%%%%%