#######
#.....#
#..#..#
#.###.#
#..#..#
#....@#
#######